Mecânica:

Fórmula da velocidade média: v = Δx/Δt
Fórmula da aceleração média: a = Δv/Δt
Fórmula da velocidade final: v = v₀ + at
Fórmula da posição final: x = x₀ + v₀t + (1/2)at²
Fórmula da velocidade em queda livre: v = gt
Fórmula da altura em queda livre: h = (1/2)gt²
Fórmula do trabalho realizado: W = F * d * cosθ
Fórmula da energia cinética: K = (1/2)mv²
Fórmula da energia potencial gravitacional: U = mgh
Fórmula da energia mecânica: E = K + U
Fórmula da força centrípeta: Fc = (mv²)/r
Fórmula da lei da gravitação universal: F = G * (m₁ * m₂)/r²
Fórmula da lei de Hooke: F = k * Δx
Fórmula do impulso: J = FΔt
Fórmula do momento linear: p = mv
Fórmula da lei da conservação do momento linear: m₁v₁ + m₂v₂ = m₁v₁' + m₂v₂'
Fórmula da lei de conservação da energia mecânica: K₁ + U₁ = K₂ + U₂
Fórmula do torque: τ = rFsinθ
Fórmula do momento de inércia: I = m * r²
Fórmula da lei de conservação do momento de inércia: I₁ω₁ = I₂ω₂
Termodinâmica:
21. Fórmula da variação de temperatura (escala Celsius): ΔT = Tf - Ti

Fórmula da variação de temperatura (escala Kelvin): ΔT = Tf - Ti
Fórmula da quantidade de calor: Q = mcΔT
Fórmula da capacidade térmica: C = Q/ΔT
Fórmula da lei zero da termodinâmica: Tf = Tc
Fórmula da lei de Boyle: P₁V₁ = P₂V₂
Fórmula da lei de Charles: V₁/T₁ = V₂/T₂
Fórmula da lei de Gay-Lussac: P₁/T₁ = P₂/T₂
Fórmula da lei dos gases ideais: PV = nRT
Fórmula da eficiência térmica: η = (W/Qh) * 100%
Óptica:
31. Fórmula da velocidade da luz: c = λν

Fórmula da frequência: ν = c/λ
Fórmula do aumento linear: A = hi/ho
Fórmula do aumento angular: A = θi/θo
Fórmula da distância focal: f = (R₁ * R₂)/(R₁ + R₂)
Fórmula da ampliação do espelho plano: A = -di/do
Fórmula da ampliação do espelho esférico: A = hi/ho = -di/do
Fórmula da lei de Snell: n₁sinθ₁ = n₂sinθ₂
Fórmula da vergência da lente: P = 1/f
Fórmula do aumento linear da lente: A = hi/ho = -di/do
Eletromagnetismo:
41. Fórmula da força elétrica: F = k * (|q₁| * |q₂|)/r²

Fórmula do campo elétrico: E = F/q
Fórmula do potencial elétrico: V = k * |q|/r
Fórmula do campo magnético: B = μ₀ * (I/2πr)
Fórmula da força magnética em um condutor retilíneo: F = BILsinθ
Fórmula da força magnética em uma carga em movimento: F = qvBsinθ
Fórmula da força magnética em uma partícula carregada em um campo elétrico: F = qEsinθ
Fórmula da força magnética em um condutor percorrido por corrente em um campo magnético: F = BILsinθ
Fórmula da lei de Faraday: ε = -dΦ/dt
Fórmula da lei de Ampère: B∫dl = μ₀ * Ienc
Ondas e Som:
51. Fórmula da velocidade de uma onda: v = λf

Fórmula da frequência de uma onda: f = v/λ
Fórmula do período de uma onda: T = 1/f
Fórmula da intensidade de uma onda: I = P/A
Fórmula da lei de Snell-Descartes: n₁sinθ₁ = n₂sinθ₂
Fórmula da frequência fundamental de uma corda vibrante: f₁ = v/2L
Fórmula da frequência de harmônicos em uma corda vibrante: fn = nf₁
Fórmula da velocidade do som: v = √(γRT)
Fórmula da frequência fundamental de um tubo sonoro aberto: f₁ = v/2L
Fórmula da frequência fundamental de um tubo sonoro fechado: f₁ = v/4L
Eletrostática:
61. Fórmula da lei de Coulomb: F = k * (|q₁| * |q₂|)/r²

Fórmula do campo elétrico: E = F/q
Fórmula do potencial elétrico: V = k * |q|/r
Fórmula da capacitância: C = Q/V
Fórmula da energia potencial elétrica: U = (1/2)CV²
Fórmula da energia elétrica armazenada em um capacitor: U = (1/2)QV
Fórmula da energia potencial elétrica de um sistema de cargas: U = k * (|q₁||q₂|)/r
Fórmula da lei de Gauss: Φ = E * A = Qenc/ε₀
Fórmula da força elétrica entre placas paralelas de um capacitor: F = EQ
Fórmula do campo elétrico produzido por um capacitor plano: E = σ/ε₀, onde σ é a densidade de carga superficial
Magnetismo:
71. Fórmula da força magnética em um condutor retilíneo: F = BILsinθ

Fórmula da força magnética em uma carga em movimento: F = qvBsinθ
Fórmula da força magnética em uma partícula carregada em um campo elétrico: F = qEsinθ
Fórmula da força magnética em um condutor percorrido por corrente em um campo magnético: F = BILsinθ
Fórmula do campo magnético produzido por um fio retilíneo: B = (μ₀ * I)/(2πr)
Fórmula do campo magnético no centro de uma espira circular: B = (μ₀ * I)/(2R)
Fórmula do campo magnético no centro de uma solenoide: B = μ₀ * nI
Fórmula da indução magnética em uma espira: Φ = BAcosθ
Fórmula da força eletromotriz induzida: ε = -dΦ/dt
Fórmula da lei de Ampère: B∫dl = μ₀ * Ienc
Óptica Geométrica:
81. Fórmula da velocidade da luz: c = 3.00 x 10^8 m/s

Fórmula da lei de Snell-Descartes: n₁sinθ₁ = n₂sinθ₂
Fórmula da lente delgada: 1/f = (n-1) * (1/R₁ - 1/R₂)